abezedaio	a b e s̻ e d̪ a i o
agogarbi	a ɡ o ɡ a ɾ b i
aitapuntako	a i t̪ a p u n t̪ a k o
alondai	a l o n d̪ a i
ametitu	a m e t̪ i t̪ u
andragai	a n d̪ ɾ a ɡ a i
apapa	a p a p a
apetitu	a p e t̪ i t̪ u
apopilo	a p o p i l o
arabaize	a ɾ a b a i s̻ e
ardai	a ɾ d̪ a i
ateik	a t̪ e i k
ato-poto	a t̪ o p o t̪ o
atxitaporru	a t̪ ʃ i t̪ a p o r u
aurpei	a u ɾ p e i
autsi	a u t̪ s̺ i
autzi	a u t̪ s̻ i
auztaile	a u s̻ t̪ a i l e
axai	a ʃ a i
axolabaiko	a ʃ o l a b a i k o
aza	a s̻ a
azkeineko	a s̻ k e i n e k o
azpitigora	a s̻ p i t̪ i ɡ o ɾ a
aztapatu	a s̻ t̪ a p a t̪ u
babarrun	b a b a r u n
babatxui	b a b a t̪ ʃ u i
baile	b a i l e
baindo	b a i n d̪ o
baitaziare	b a i t̪ a s̻ i a ɾ e
bandido	b a n d̪ i d̪ o
bebuz	b e b u s̻
beinke	b e i n k e
bekoki	b e k o k i
besteik	b e s̺ t̪ e i k
besteineko	b e s̺ t̪ e i n e k o
betetuzu	b e t̪ e t̪ u s̻ u
biba	b i b a
bibora	b i b o ɾ a
bihozbeiko	b i o s̻ b e i k o
bobil	b o b i l
bobildu	b o b i l d̪ u
botatu	b o t̪ a t̪ u
bubeiko	b u b e i k o
bubeltx	b u b e l t̪ ʃ
bugogor	b u ɡ o ɡ o ɾ
bulkakan	b u l k a k a n
burubeiko	b u ɾ u b e i k o
dado	d̪ a d̪ o
dainatu	d̪ a i n a t̪ u
dainu	d̪ a i n u
dau	d̪ a u
deabrukei	d̪ e a b ɾ u k e i
deina	d̪ e i n a
dendai	d̪ e n d̪ a i
desigualdade	d̪ e s̺ i ɡ u a l d̪ a d̪ e
despeitu	d̪ e s̺ p e i t̪ u
diskutitu	d̪ i s̺ k u t̪ i t̪ u
dot	d̪ o t̪
duda	d̪ u d̪ a
dudaipe	d̪ u d̪ a i p e
ebaitu	e b a i t̪ u
ebei	e b e i
ebeikin	e b e i k i n
ebein	e b e i n
edade	e d̪ a d̪ e
edai	e d̪ a i
endaitza	e n d̪ a i t̪ s̻ a
enpapatu	e n p a p a t̪ u
enpatxatu	e n p a t̪ ʃ a t̪ u
erokei	e ɾ o k e i
esanko	e s̺ a n k o
eskeini	e s̺ k e i n i
eskukada	e s̺ k u k a d̪ a
etze	e t̪ s̻ e
exeri	e ʃ e ɾ i
frutei	f ɾ u t̪ e i
gagar	ɡ a ɡ a ɾ
gahio	ɡ a i o
gaihai	ɡ a i a i
gainu	ɡ a i n u
galbai	ɡ a l b a i
galbaiu	ɡ a l b a i u
galdein	ɡ a l d̪ e i n
gaztetasun	ɡ a s̻ t̪ e t̪ a s̺ u n
gaztetu	ɡ a s̻ t̪ e t̪ u
gogoipe	ɡ o ɡ o i p e
goxo	ɡ o ʃ o
guai	ɡ u a i
hamarrendai	a m a r e n d̪ a i
hankako	a n k a k o
hausi	a u s̺ i
hozkakan	o s̻ k a k a n
huskei	u s̺ k e i
ikaztei	i k a s̻ t̪ e i
in	i n
ixildu	i ʃ i l d̪ u
jaunkakan	x a u n k a k a n
kafetei	k a f e t̪ e i
kaila	k a i l a
kainu	k a i n u
kaixa	k a i ʃ a
kankailu	k a n k a i l u
kanpotar	k a n p o t̪ a ɾ
kantaita	k a n t̪ a i t̪ a
kapital	k a p i t̪ a l
kasoitaile	k a s̺ o i t̪ a i l e
kika	k i k a
kikarakada	k i k a ɾ a k a d̪ a
koko	k o k o
kokoteaindo	k o k o t̪ e a i n d̪ o
komodidade	k o m o d̪ i d̪ a d̪ e
kuku	k u k u
kukukan	k u k u k a n
lantai	l a n t̪ a i
lastail	l a s̺ t̪ a i l
lastaira	l a s̺ t̪ a i ɾ a
lukaika	l u k a i k a
lurpetu	l u ɾ p e t̪ u
matain	m a t̪ a i n
mordotxo	m o ɾ d̪ o t̪ ʃ o
motzoi	m o t̪ s̻ o i
moztaile	m o s̻ t̪ a i l e
muxu	m u ʃ u
nahastaile	n a a s̺ t̪ a i l e
notaio	n o t̪ a i o
oilatai	o i l a t̪ a i
ospital	o s̺ p i t̪ a l
ostikokan	o s̺ t̪ i k o k a n
otaipuko	o t̪ a i p u k o
pailazo	p a i l a s̻ o
paisaje	p a i s̺ a x e
panadei	p a n a d̪ e i
papartxui	p a p a ɾ t̪ ʃ u i
pape	p a p e
pekatai	p e k a t̪ a i
pepino	p e p i n o
petaka	p e t̪ a k a
pilotai	p i l o t̪ a i
pintotu	p i n t̪ o t̪ u
piperpoto	p i p e ɾ p o t̪ o
pisutsu	p i s̺ u t̪ s̺ u
piti-poto	p i t̪ i p o t̪ o
pitilin	p i t̪ i l i n
pito	p i t̪ o
pote	p o t̪ e
pupu	p u p u
puta	p u t̪ a
putzu	p u t̪ s̻ u
putzutai	p u t̪ s̻ u t̪ a i
remolkekada	ɾ e m o l k e k a d̪ a
repetitu	ɾ e p e t̪ i t̪ u
segapoto	s̺ e ɡ a p o t̪ o
sekretaio	s̺ e k ɾ e t̪ a i o
senargai	s̺ e n a ɾ ɡ a i
suerteta	s̺ u e ɾ t̪ e t̪ a
sutai	s̺ u t̪ a i
sutaila	s̺ u t̪ a i l a
tapa	t̪ a p a
tapete	t̪ a p e t̪ e
tapilu	t̪ a p i l u
teilatupe	t̪ e i l a t̪ u p e
tentetu	t̪ e n t̪ e t̪ u
tetano	t̪ e t̪ a n o
tipula	t̪ i p u l a
tontei	t̪ o n t̪ e i
tontotu	t̪ o n t̪ o t̪ u
tope	t̪ o p e
total	t̪ o t̪ a l
tripote	t̪ ɾ i p o t̪ e
tuzu	t̪ u s̻ u
txapape	t̪ ʃ a p a p e
txapitela	t̪ ʃ a p i t̪ e l a
txikikei	t̪ ʃ i k i k e i
txutxupe	t̪ ʃ u t̪ ʃ u p e
unibersidade	u n i b e ɾ s̺ i d̪ a d̪ e
urtetxo	u ɾ t̪ e t̪ ʃ o
usatai	u s̺ a t̪ a i
yaitaile	j a i t̪ a i l e
yauli	j a u l i
yauri	j a u ɾ i
zakukada	s̻ a k u k a d̪ a
zartai	s̻ a ɾ t̪ a i
zartaiti	s̻ a ɾ t̪ a i t̪ i
zeiti	s̻ e i t̪ i
zengeiti	s̻ e n ɡ e i t̪ i
zorroztaile	s̻ o r o s̻ t̪ a i l e
zurrakapote	s̻ u r a k a p o t̪ e
zutitu	s̻ u t̪ i t̪ u
zutituazi	s̻ u t̪ i t̪ u a s̻ i
